5 11
    9    25    33    59     9    10     7    22    68     3    11
    6    42    15     9     9     8    25    38    57    65    26
   51    25    23    82    83    15    90    11    15    32    19
   50    14    84    41    16    26    18    70    17    90    25
   89    84    33    10    89    86    25    67    21    66    21