7 10
   33    54    69     2    65    28    56    52     9    51
    9    32     7     7    83    16    65    10    40     7
   23    85    24    33    41    73    68    26    12    66
   83    59    19     5    27    59    88    20    35     4
   27     8    26    34    40    87    45    59     8    87
   10    37    28    39    18    25    90     8    58    22
   16    19    37    71    82    10     3    15    11     7