5 15
   13    85     7    43    26    84    29    10    32    26    33    88    14    26    11
   89    90     4    18    12    83     9    56     7    11     2    26    46    52    65
   24    55    59     4     4    10    40    40    90    30    45    19    84     8    27
   66     8    46    72    13     9    74    54    12    26     3    72    19     8    56
   57    89    23    85    27    18    27    84    66     5    12    19     2    13    38
   